Level 4
________________
map()

#########
#@#######
#    ####
#### ####
####  ###
##### ###
##### ###
#####   #
#######*#
#########

undefined

