Level 3
________________________
map()

##########
#@########
#  #######
##  ######
###  #####
####  ####
#####  ###
######  ##
####### *#
##########

undefined

