Level 5
_______________
map()

#########
#@      #
####### #
#   #   #
# # # ###
# # # ###
# #   ###
# #######
#      *#
#########

undefined
